WWWWWWWWWW
W  B     W
W  HHHH  W
W   R    W
W   XWWWWW
W    W    
W  S W   W
W   AW   W
W        W
WWWWWWWWWW