WWWWWWWWWW
W     C  W
W  HHHH  W
W    b   W
W    WWWWW
W R CX    
W   SW   W
W    W   W
W BO     W
WWWWWWWWWW