WWWWWWWWWW
W  T  C  W
W  HHHH  W
W    b   W
W    WWWWW
W R CX    
W   SW   W
W    WA  W
W       BW
WWWWWWWWWW