WWWWWWWWWW
W     C  W
W  HHHH  W
W   A    W
W    WWWWW
W R CX    
W   SW   W
W    W   W
W B      W
WWWWWWWWWW