WWWWWWWWWW
W  B     W
W  HHHH  W
W   A    W
W   XWWWWW
W    W    
W  S W   W
W R  W   W
W  R     W
WWWWWWWWWW