WWWWWWWWWW
W     C  W
W  HHHH  W
W   A    W
W   XWWWWW
W R  W    
W  S W   W
W    W   W
W B      W
WWWWWWWWWW